111111111111111111
100C0000C000C000E1
1C0000001110000001
1000C00000110EC001
10001110000C000001
1P00C000C0000C0001
111111111111111111
