1111111111111111111111111111111
100C0000C000C000E00000000000001
1C00000011100000000000000000001
1000C00000110000000111100000001
1000111000000000000000000000001
1P000000C0000000000000000000001
1111111111111111111111111111111
