11111111111111111111111111111
10000000001000C0000C000C00001
1C000000001000000001110000001
100000E00010000C000001100C001
1000000000100001110000C000001
1P0000000010000C000C0000C0001
11111111111111111111111111111
